111111111111
10E000000001
100P00000001
10C000000001
100000000001
100000000001
100000000001
100000000001
111111111111