111111111111
10E0000X0001
100P00000001
10C000011111
1000X0000001
111111110001
10000000C011
10C0X0000001
111111111111